X X X X X X X X X X X X X X X X X X X X
X G O O O O O O O O O O O O O O O O G X
X O O O O O O O O O O O O O O O O O O X
X X X X X O O O O O O O X X X X X O O X
X O O O X O O O O O O O X O O O O O O X
X O O O X O O O O O O O X O O O O O O X
X O O O O O O O O O O O X O O O O O O X
X O O O O X X X X X X X X O O O O O O X
X O O O O X X X X X X X X O O O O O O X
X O O O O X X X X X X X X O O O O O O X
X O O O O O O O O O O O O O O O X X X X
X X X O O O X O O O O O O O O O X O O X
X O X O O O X P O O O O O O O O X O O X
X O X O O O X X X X O O O O O O X O O X
X O X O O O O O O X O O O O O O O O O X
X G O O O O O O O X O O O O O O O O G X
X X X X X X X X X X X X X X X X X X X X
